000p0000000000000000
00000000000000000000
00000000001111110000
00000000000000000000
00000000000000000000
00001111000000000000
00000000000000000000