000000000000000000000000
00000BIY000000WIS0000000
000w00000000000000000000
00wfw0000000000000090000
000w000wwwrrwww000000000
0000000w000000w000000000
0000000w0RISP0w00FI00000
0000000w00b000w000000000
0000000wwwwwwww000000000